iph	iphone
hexx	hexa
罗文浩	罗文干
ixxx	iphonexx
natia	nativ
history	history
nation	nation
中共革命	闹革命
中国人民银行	中国人民银行
genreic	genseric
k	kA
hello	hello
网达	亨达
abdcd	abdc
national	national
王到	拣到
中国	中国
chat	chat
k	kA
王道	王道
罗	罗丰
heoo	hcoo
histor	istor
sver	sver
xxxx	xxx
